111111111111111
1P0000000C00001
111011101110111
1C00000000000C1
101111110111101
10000000E000001
101111110111101
1C00000000000C1
111011101110111
1C0000000C000C1
101111110111101
100000000000001
1C000C0000C00C1
111011101110111
111111111111111
