11111111111111
10000000000011
10000000000011
10000000000011
10000000000011
10000000000011
1000PEC0000011
11111111111111
