111111111111111111111111111
100000000000000000000000001
10000000P000000000000000001
10000X0000000000C00000000E1
111111111111111111111111111