111111111
1P0C0C001
101010101
10C0C0C01
101010101
10C0C0C01
101010101
1E0C0C0C1
111111111
